基线资料	Baseline_Characteristics	数据情况
年龄	Age	整数（0-100）
性别	Sex	字符串（Male,Female,N/A）
体重指数	Body_Mass_Index_BMI	浮点数（e.g. 2.4 kg/m²）
体表面积	Surface_Area	浮点数（e.g. 2.4 m²）
糖尿病	Diabetes_Mellitus	布尔值（True/False）
高血压	Hypertension	布尔值（True/False）
高脂血症	Hyperlipidemia	布尔值（True/False）
冠心病	Coronary_Artery_Disease	布尔值（True/False）
慢阻肺	Chronic_Obstructive_Pulmonary_Disease_COPD	布尔值（True/False）
透析	Dialysis	布尔值（True/False）
房颤	Atrial_Fibrillation	布尔值（True/False）
纽约心脏病协会分级	New_York_Heart_Association_NYHA_Classification	字符串（I, II, III, N/A）
血管紧张素转换酶抑制剂/血管紧张素Ⅱ受体拮抗剂	Angiotensin_Converting_Enzyme_Inhibitor_ACEI_or_Angiotensin_II_Receptor_Blocker_ARB	布尔值（True/False）
Beta受体阻滞剂	Beta_Receptor_Blocker	布尔值（True/False）
钙离子阻滞剂	Calcium_Ion_Blocker	布尔值（True/False）
利尿剂	Diuretic	布尔值（True/False）
阿司匹林	Aspirin	布尔值（True/False）
抗凝药	Anticoagulant	布尔值（True/False）
他汀类药物	Statins	布尔值（True/False）
心梗	Myocardial_Infarction_History	布尔值（True/False）
经皮冠状动脉介入术	Percutaneous_Coronary_Intervention_PCI_History	布尔值（True/False）
冠状动脉旁路移植术	Coronary_Artery_Bypass_Grafting_CABG_History	布尔值（True/False）
胸外科医师学会评分	Society_of_Thoracic_Surgeons_STS_Score	浮点数
氨基末端B型利钠肽前体	NT_proBNP_Level_Value	浮点数
钠-葡萄糖共转运蛋白2抑制剂	Sodium-Glucose Cotransporter 2 inhibitors	布尔值（True/False）



术前影像学评估	TAVI_R_Preprocedural_Imaging_Assessment	数据情况
左心室射血分数	LVEF	浮点数（e.g. 24%）
最大主动脉瓣跨瓣压差	Preprocedural_Aortic_Valve_Peak_PG	浮点数（e.g. 2.4 mmHg）
平均主动脉瓣跨瓣压差	Preprocedural_Aortic_Valve_Mean_PG	浮点数（e.g. 2.4 mmHg）
有效瓣口面积（主动脉瓣）	Aortic_Valve_EOA	浮点数（e.g. 2.4 cm²）
有效瓣口面积指数（主动脉瓣）	Aortic_Valve_EOAI	浮点数
中度以上主动脉瓣反流	Moderate_Or_Severe_Aortic_Regurgitation_AR	布尔值（True/False）
中度以上二尖瓣反流	Mitral_Valve_Regurgitation_Is_Moderate_Or_Severe	布尔值（True/False）
左心室舒张末期容积	Left_Ventricular_End_Diastolic_Volume_LVEDV	浮点数（e.g. 2.4 ml）
左心室收缩末期容积	Left_Ventricular_End_Systolic_Volume_LVESV	浮点数（e.g. 2.4 ml）
瓣环面积（主动脉瓣）	Aortic_Valve_Annular_Area	浮点数（e.g. 2.4 cm²）
瓣环平均直径（主动脉瓣）	Aortic_Valve_Annular_Mean_Diameter	浮点数（e.g. 2.4 mm）
瓣环最小直径（主动脉瓣）	Aortic_Valve_Annular_Min_Diameter	浮点数（e.g. 2.4 mm）
瓣环最大直径（主动脉瓣）	Aortic_Valve_Annular_Max_Diameter	浮点数（e.g. 2.4 mm）
瓣环周径（主动脉瓣）	Aortic_Valve_Annular_Perimeter	浮点数（e.g. 2.4 mm）
瓣环偏心率（主动脉瓣）	Aortic_Valve_Annular_Eccentricity_Index	浮点数
源自面积的瓣环直径（主动脉瓣）	Aortic_Valve_Area_Derived_Annular_Diameter	浮点数（e.g. 2.4 mm）
源自周长的瓣环直径（主动脉瓣）	Aortic_Valve_Perimeter_Derived_Annular_Diameter	浮点数（e.g. 2.4 mm）
主动脉瓣口流速	Aortic_Valve_Flow_Velocity	浮点数
窦管交界高度	Sinotubular_Junction_STJ_Diameter_Height	浮点数（e.g. 2.4 mm）
窦管交界直径	Sinotubular_Junction_STJ_Diameter	浮点数（e.g. 2.4 mm）
窦部直径（主动脉根部）	Sinus_Of_Valsalva_Mean_Diameter	浮点数（e.g. 2.4 mm）
升主动脉直径	Ascending_Aorta_Diameter_At_Pulmonary_Artery_Bifurcation	浮点数（e.g. 2.4 mm³）
瓣环上钙化（主动脉瓣）	Aortic_Valve_Supraannular_Calcification_Volume	浮点数（e.g. 2.4 mm³）
瓣环钙化（主动脉瓣）	Aortic_Valve_Annular_Calcification_Volume	浮点数（e.g. 2.4 mm³）
左心室流出道直径	Left_Ventricular_Outflow_Tract_LVOT_Diameter	浮点数（e.g. 2.4 mm³）
左心室流出道钙化体积	Left_Ventricular_Outflow_Tract_LVOT_Calcification_Volume	浮点数（e.g. 2.4 mm）
左冠脉高度（主动脉根部）	Left_Coronary_Ostium_Height_From_Annulus	浮点数（e.g. 2.4 mm）
右冠脉高度（主动脉根部）	Right_Coronary_Ostium_Height_From_Annulus	浮点数（e.g. 2.4 mm）
瓣环至二尖瓣前叶距离	Annalus_To_Anterior_Leaflet_Of_Mitral_Valve_Distance	浮点数（e.g. 2.4 mm）



手术信息	​​TAVI_R_Procedural_Details	数据情况
经股动脉入路	Access_Approach_Transfemoral	布尔值（True/False）
经心尖入路	Access_Approach_Transapical	布尔值（True/False）
其它入路	Access_Approach_Other	字符串（经颈动脉入路（transcarotid artery approach）, 经锁骨下动脉入路（transubclavian artery approach）, 经主动脉入路（transaortic approach））
瓣膜尺寸	THV size	float
瓣膜类型	THV_Type	字符串（Self-expandable/Balloon-expandable）
瓣膜品牌	THV_Brand_name	字符串(ACURATE Neo, Avalus, CoreValve, Edwards, Edwards SAPIEN, Evolut, Hancock, INSPIRIS, Inoue, Inovare, J-Valve, JenaValve, LOTUS, Medtronic Mosaic, MyVal, Navitor, PERCEVAL-S, Portico, St Jude, Tyshak, Venus, Vitaflow Liberty,Taurus Elite)
预扩张	Pre_Dilation_Performed	布尔值（True/False）
后扩张	Post_Dilation_Performed	布尔值（True/False）
总术时	TAVI_R_Total_Procedure_Time	浮点数
造影时间	TAVI_R_Fluoroscopy_Time	浮点数
造影量	TAVI_R_Contrast_Volume	浮点数
术后即刻左心室射血分数	TAVI_R_Immediate_PostProcedural_LVEF	浮点数（e.g. 24%）
术后即刻主动脉瓣跨瓣压差	TAVI_R_Immediate_PostProcedural_Aortic_Valve_Mean_PG	浮点数
主动脉瓣跨瓣压差≥20 mmHg	TAVI_R_Immediate_PostProcedural_Aortic_Valve_Mean_PG_gte_20	布尔值（True/False）
严重错位	Prosthesis_Malposition	布尔值（True/False）
瓣环撕裂	Annular_Rupture	布尔值（True/False）
过大尺寸	Excessive_Oversizing_Occurred	布尔值（True/False）
尺寸过大≥15%	Oversizing_Rate_gte_15_percent	布尔值（True/False）
术后是否即刻瓣周漏	TAVI_R_Immediate_PostProcedural_PVL_Occurred	布尔值（True/False）
术后即刻瓣周漏程度	TAVI_R_Immediate_PostProcedural_PVL_Severity	字符串（微量（trace）, 轻度（mild）, 中度（moderate）, 重度（severe），N/A）‘Trivial’，‘Minimal’与‘Trace’同义
瓣架移位	THV_Displacement_Or_Embolization	布尔值（True/False）
转外科开胸手术	Conversion_To_SAVR_Required	布尔值（True/False）
转心肺转流术	Cardiopulmonary_Bypass_CPB_Required	布尔值（True/False）
瓣中瓣	Valve_In_Valve_For_Acute_Failure_Or_Malposition	布尔值（True/False）
围术期死亡	TAVI_R_Periprocedural_Death_In_Hospital	布尔值（True/False）
二尖瓣返流变化	Mitral_Regurgitation_Change	字符串（增加（Increase）、减少（Decrease）、无变化（Null））



出院前评价	TAVI_R_Evaluation_PostProcedure_Before_Discharge​	数据情况
出院前死亡	Death_Before_Discharge	布尔值（True/False）
卒中	Stroke_Before_Discharge	布尔值（True/False）
大出血	Life_Threatening_Bleeding_Before_Discharge	布尔值（True/False）
急性肾衰	Acute_Kidney_Injury_AKI_Before_Discharge	布尔值（True/False）
严重血管并发症	Major_Vascular_Complication_Before_Discharge	布尔值（True/False）
心肌梗死/急性心肌梗死	Myocardial_infarction_or_Acute_myocardial_infarction_Before_Discharge	布尔值（True/False）
急性冠脉综合征/缺血性心脏病	Acute_coronary_syndrome_or_Ischemic_heart_disease_Before_Discharge	布尔值（True/False）
心力衰竭	Heart_failure_Before_Discharge	布尔值（True/False）
所有原因死亡和心血管死亡	All_cause_death_and_cardiovascular_death_Before_Discharge	布尔值（True/False）
起搏器植入	New_Permanent_Pacemaker_Implantation_PPMI_Before_Discharge	布尔值（True/False）
出院前是否瓣周漏	PVL_Detected_Before_Discharge	布尔值（True/False）
出院前瓣周漏程度	PVL_Severity_Before_Discharge	字符串（微量（trace）, 轻度（mild）, 中度（moderate）, 重度（severe），N/A）
出院前最大主动脉瓣跨瓣压差	Aortic_Valve_Max_PG_Before_Discharge	浮点数（e.g. 2.4 mmHg）
出院前主动脉瓣口流速	Aortic_Valve_Flow_Velocity_Before_Discharge	浮点数
出院前平均主动脉瓣跨瓣压差	Aortic_Valve_Mean_PG_Before_Discharge	浮点数（e.g. 2.4 mmHg）
出院前实测有效瓣口面积指数	Aortic_Valve_EOAI_Before_Discharge	浮点数
二尖瓣返流变化	Mitral_Regurgitation_Change	字符串（增加（Increase）、减少（Decrease）、无变化（Null））



随访信息	TAVI_R_Follow_up_Characteristics	数据情况
30天全因	All_Cause_Mortality_At_30_Days	布尔值（True/False）
30天心梗	Myocardial_Infarction_At_30_Days	布尔值（True/False）
30天卒中	Stroke_At_30_Days	布尔值（True/False）
30天心衰再住院	Heart_Failure_Readmission_At_30_Days	布尔值（True/False）
1年全因	All_Cause_Mortality_At_1_Year	布尔值（True/False）
1年心梗	Myocardial_Infarction_At_1_Year	布尔值（True/False）
1年卒中	Stroke_At_1_Year	布尔值（True/False）
1年心衰再住院	Heart_Failure_Readmission_At_1_Year	布尔值（True/False）
左心室射血分数	LVEF_At_Last_Follow_up	浮点数（e.g. 24%）
纽约心脏病协会分级	New_York_Heart_Association_NYHA_Classification_At_Last_Follow_up	字符串（I, II, III, N/A）
最大主动脉瓣跨瓣压差	Aortic_Valve_Max_PG_At_Last_Follow_up	浮点数（e.g. 2.4 mmHg）
主动脉瓣口流速	Aortic_Valve_Flow_Velocity_At_Last_Follow_up	浮点数
平均主动脉瓣跨瓣压差	Aortic_Valve_Mean_PG_At_Last_Follow_up	浮点数（e.g. 2.4 mmHg）
有效瓣口面积	Aortic_Valve_EOA_At_Last_Follow_up	浮点数（e.g. 2.4 cm²）
有效瓣口面积指数	Aortic_Valve_EOAI_At_Last_Follow_up	浮点数
是否瓣周漏	PVL_Detected_At_Last_Follow_up	布尔值（True/False）
瓣周漏程度	PVL_Severity_At_Last_Follow_up	字符串（微量（trace）, 轻度（mild）, 中度（moderate）, 重度（severe），N/A）
患者是否因 ​​TAVI（经导管主动脉瓣植入术）相关并发症​​ 而接受了 ​​后续干预​​（如二次手术、补救治疗等）	Subsequent_Intervention_For_TAVI_R_Complication_Occurred	布尔值（True/False）
 ​​后续干预的具体类型​​ 和 ​​发生时间​​（仅在发生干预时填写）	Subsequent_Intervention_Type_And_Timing_If_Occurred	string
术后封堵	Occlusion_Procedure_Post_TAVI_R	布尔值
二次手术	Reoperation_Post_TAVI_R	布尔值
术后中转开胸	Conversion_to_Open_Surgery_Post_TAVI_R	布尔值
术后起搏器植入	Pacemaker_Implantation_Post_TAVI_R	布尔值
术后瓣膜脱落	Valve_Dislodgement_Post_TAVI_R	布尔值
术后主动脉夹层	Aortic_Dissection_Post_TAVI_R	布尔值
术后血肿	Hematoma_Post_TAVI_R	布尔值
术后心衰	Heart_Failure_Post_TAVI_R	布尔值
二尖瓣返流变化	Mitral_Regurgitation_Change	字符串（增加（Increase）、减少（Decrease）、无变化（Null））

